SANDVEIL=Velo de Arena
OBLIVIOUS=Despistado
WATERABSORB=Absorbeagua
VOLTABSORB=Absorbevoltios
COLORCHANGE=Cambio de Color
FLASHFIRE=Absorbefuego
SHIELDDUST=Superguardia
NATURALCURE=Curación Natural
EARLYBIRD=Madrugador
FLAMEBODY=Cuerpo de Fuego
RAINDISH=Curación Pluvial
SANDSTREAM=Chorro de Arena
MAGMAARMOR=Escudo de Magma
WATERVeil=Velo de Agua
SOUNDPROOF=Insonorización
PICKUP=Recolección
KEENEYE=Perspicacia
SEOFFIRE=Mar de Llamas
GOOEY=Toxisecreción
TANGLEDFEET=Tambaleo
ARENATRAP=Trampa de Arena
SNIPER=Puntería
HEALER=Alma Sanadora
DEFEATIST=Flaquear
ICEBODY=Cuerpo de Hielo
HONEYGATHER=Cosechamiel
FRISK=Inspección
UNAWARE=Ignorancia
KLUTZ=Torpeza
SUPERLUCK=Supersuerte
AFTERMATH=Secuela
MEGALAUNCHER=Megalanzador
CHEEKPOUCH=Mejillas
FLOWERVEIL=Velo Florido
AROMAVEIL=Velo Aromático
ZENMODE=Modo Zen
PRANKSTER=Timador
SANDSPOWER=Poder Arenoso
MIRACLESKIN=Piel Milagrosa
MOODY=Temperamental
POISONTOUCH=Contacto Tóxico
WATERBUBBLE=Acuaburbuja
LINGERINGAROMA=Aroma Incesante
WELLBAKEDBODY=Pan Comido
COMMANDER=Comandante
SINGLEMINDED=Obstinación
BALLFETCH=Buscabola
ANGERPOINT=Ira
EMERGENCYEXIT=Socorro
FLUFFY=Mullido
BEADSOFRUIN=Cuenta Debacle