MASTERBALL=Masterbola
ULTRABALL=Ultrabola
GREATBALL=Superbola
POKEBALL=Pokébola
SAFARIBALL=Safaribola
NETBALL=Mallabola
DIVEBALL=Buceobola
NESTBALL=Nidobola
REPEATBALL=Acopiobola
TIMERBALL=Turnobola
LUXURYBALL=Lujobola
PREMIERBALL=Honorbola
DUSKBALL=Ocasobola
HEALBALL=Sanabola
QUICKBALL=Velozbola
CHERISHBALL=Gloriabola
LUREBALL=Señuelobola
HEAVYBALL=Pesabola
FRIENDBALL=Amigobola
LOVEBALL=Amorbola
MOONBALL=Lunabola
SPORTBALL=Competibola
PARKBALL=Parquebola
GIGATONBALL=Quintalbola
STRANGEBALL=Extrañabola
BURNHEAL=Antiquemaduras
FULLRESTORE=Restauratodo
MAXPOTION=Curación Total
ELIXIR=Elíxir
MAXELIXIR=Elíxir Máximo
BERRYJUICE=Jugo de Baya
BIGPEARL=Gran Perla
STARDUST=Polvo Estrella
STARPIECE=Fragmento Estrella
GROWTHMULCH=Abono Germinador
GRISEOUSORB=Griseoesfera
ADAMANTORB=Lustroesfera
INVITATION=Carta Invitación
PECHABERRY=Baya Duraz
ASPEARBERRY=Baya Citrón
TANGABERRY=Baya Látano
LANSATBERRY=Baya Lansat
POWERBAND=Brazalete Firme
DRAGONSCALE=Escama Dragón
BLACKGLASSES=Lentes de Sol
DRAGONFANG=Colmillo Dragón
SHELLBELL=Cascabel Nácar
GREENSCARF=Pañuelo Esmeralda
WISEGLASSES=Lentes Especiales
LIFEORB=Vidaesfera
TOXICORB=Toxiesfera
FLAMEORB=Llamaesfera
QUICKPOWDER=Polvo Velocidad
DESTINYKNOT=Hilo Destino
POWERBELT=Cinturón Recio
POWERLENS=Lente Recio
SHEDSHELL=Muda de Piel
CHOICESPECS=Lentes Elección
FLAMEPLATE=Placa Llama
MEADOWPLATE=Placa Linfa
SPLASHPLATE=Placa Trueno
ZAPPLATE=Placa Trueno
MINDPLATE=Placa Mental
EARTHPLATE=Placa Terral
SKYPLATE=Placa Cielo
FISTPLATE=Placa Pelea
TOXICPLATE=Placa Tóxica
INSECTPLATE=Placa Insecto
STONEPLATE=Placa Pétrea
SPOOKYPLATE=Placa Terror
DRACOPLATE=Placa Draco
DREADPLATE=Placa Oscura
IRONPLATE=Placa Acero
SEALBAG=Bolsa de Stickers
FRIENDBOOK=Libreta de Amistades
SUPERROD=Psyrregadera
MEMBERSHIPCARD=Tarjeta de Socio
OLDSEAMAP=Boleto del Barco
SECRETPOTION=Medicamento Secreto
UNOWNREPORT=Tableta Unown
DOWSINGMCHN=Detector
GOODROD=Squirregadera
REDSCARF=Pañuelo Rojo
BLUESCARF=Pañuelo Azul
PINKSCARF=Pañuelo Rosa
GREENSCARF=Pañuelo Verde
YELLOWSCARF=Pañuelo Amarillo
MACHBIKE=Bici Mach
ACROBIKE=Bici Acro
WAILMERPAIL=Wailrregadera
DEVONSCOPE=Detector Devon
SOOTSACK=Saco de Cenizas
BASEMENTKEY=Llave del Sótano
OLDCHARM=Amuleto Antiguo
GLACIALORB=Orbe Glacial
FASHIONCASE=Estuche de Moda
TROPICALSHELL=Nácar Tropical
PROPCASE=Estuche de Accesorios
REDORB=Orbe Rojo
BLUEORB=Orbe Azul
METEORITE=Meteorito
METEORITE2=Meteorito
MACHINEPART=Pieza de Máquina
EONTICKET=Boleto Eón
POKEBLOCKCASE=Estuche de Pokécubos
LETTER=Carta para Steven
AURORATICKET=Boleto Aurora
OLDSEAMAP=Mapa Marino Antiguo
POWDERJAR=Frasco de Polvo
RUBY=Rubicunda
SAPPHIRE=Zafiro
MAGMAEMBLEM=Emblema Magma
OLDROD=Vieja Caña
SUPERROD=Supercaña
SEALCASE=Estuche de Sellos
DRAGONSKIN=Piel de Dragón
VALENCIAISLAND=Isla Valencia
VSSEEKER=Busca Retadores
SPRINKLOTAD=Lotarregadera
POKERADAR=Pokéradar
POINTCARD=Tarjeta de Puntos
LOCKCAPSULE=Cápsula Candado
PHOTOALBUM=Álbum de Fotos
GBSOUNDS=Sonidos GB
TIDALBELL=Campana Marea
JADEORB=Orbe Jade
ROTOBARGAIN=Roto Oferta
ROTOBARGIN=Roto Oferta
ROTOBARGIN2=Roto Oferta
ROTOPRIZEMONEY=Roto Premio
ROTOPPRESTORE=Roto Restaura PP
ROTOEXPPOINTS=Roto Puntos Exp
ROTOFRIENDSHIP=Roto Amistad
ROTOENCOUNTER=Roto Encuentro
ROTOSTEALTH=Roto Sigilo
ROTOHATCH=Roto Eclosión
ROTOHPRESTORE=Roto Restaura PS
ROTOCATCH=Roto Captura
XATTACK2=X Ataque 2
XDEFENSE2=X Defensa 2
XSPATK2=X Ataque Esp. 2
XSPDEF2=X Defensa Esp. 2
XSPEED2=X Velocidad 2
XACCURACY2=X Precisión 2
DYNADOSWEETS=Caramelo Dinado
TRUTHMASK=Máscara Verdad
RECONMASK=Máscara Recon
DYNADOCANDY=Caramelo Dinado
DYNADOCANDYL=Caramelo Dinado L
DYNADOCANDYXL=Caramelo Dinado XL
DYNADOBAND=Banda Dinamax
TEMPOTONIC=Tempotónico
SAFETYGOGGLES=Gafas de Seguridad
POKEFLUTE=Pokéflauta
FAIRYFEATHER=Pluma Feérica
DYNAMAXCANDY=Caramelo Dinamax
DYNAMAXCANDYL=Caramelo Dinamax L
DYNAMAXCANDYXL=Caramelo Dinamax XL
RARECANDY=Caramelo Raro
DYNAMAXORB=Orbe Dinamax
WHITEMANEHAIR=Pelaje de Melena Blanca
BLACKMANEHAIR=Pelaje de Melena Negra
ICEROOTCARROT=Zanahoria Helada
SHADEROOTCARROT=Zanahoria Sombría
BOOSTERENERGY=Energía Potenciadora
ABILITYPATCH=Parche de Habilidad
LEADERSCREST=Emblema de Líder