KARATECHOP=Golpe Karate
VISEGRIP=Fuerza de Garra
WINGATTACK=Ataque de Ala
GUST=Ráfaga de Aire
SWORDSDANCE=Danza de Espadas
WHIRLWIND=Torbellino
SLAM=Golpazo
TAILWHIP=Látigo de Cola
HORNATTACK=Ataque Cuerno
TACKLE=Tacleada
HORNDRILL=Cuerno Taladro
BODYSLAM=Golpe de Cuerpo
THRASH=Golpiza
SONICBOOM=Explosión Sónica
BITE=Mordida
POISONSTING=Piquete Venenoso
TWINEEDLE=Doble Aguijón
PINMISSILE=Misil Aguja
ICEBEAM=Rayo de Hielo
WATERGUN=Chorro de Agua
EMBER=Brasas
RAZORLEAF=Hojas Navaja
GROWTH=Crecimiento
POISONPOWDER=Polvo Venenoso
ABSORB=Absorción
MEGADRAIN=Megadrenado
PETALDANCE=Danza de Pétalos
STRINGSHOT=Disparo de Seda
THUNDERBOLT=Atactrueno
PSYCHIC=Fuerza Psíquica
SPIKECANNON=Cañón de Púas
HIGHJUMPKICK=Pat. Salto Alto
GLARE=Fulmirada
SMOG=Humo
BONECLUB=Maza de Hueso
FOCUSENERGY=Centrar Energía
DEFENSECURL=Hacerse Bolita
CONFUSERAY=Rayo de Confusión
SCREECH=Chillido
MIMIC=Mímica
FLAMEWHEEL=Rueda Ígnea
SKETCH=Boceto
SUPERFANG=Supercolmillo
FURYSWIPES=Garras Furiosas
SPORE=Esporas
DIZZYPUNCH=Puño Mareador
SKYATTACK=Ataque Celestial
BONERUSH=Hueso Veloz
ICYWIND=Viento Helado
DESTINYBOND=Lazo del Destino
FORESIGHT=Visión
OCTAZOOKA=Octazuca
POWDERSNOW=Polvo de Nieve
MACHPUNCH=Superpuño
FEINTATTACK=Ataque Finta
SCARYFACE=Cara Aterradora
FLATTER=Halago
MEMENTO=Recuerdo
FACADE=Fachada
FOCUSPUNCH=Puño Centrado
TAUNT=Provocación
HELPINGHAND=Refuerzos
ANCIENTPOWER=Poder Antiguo
MIRRORCOAT=Escudo Espejo
RAINDANCE=Danza de Lluvia
WHIRLPOOL=Remolino
SPITUP=Escupida
DRAGONBREATH=Aliento Dragón
PAINSPLIT=Dividedolor
TWISTER=Tornado
CROSSCHOP=Golpe Cruzado
MORNINGSUN=Sol Matutino
METALCLAW=Garra de Metal
IRONTAIL=Cola de Hierro
FALSESWIPE=Falsa Bofetada
SWAGGER=Fanfarronear
ROLLOUT=Rodada
MILKDRINK=Licuado
HEALBELL=Cascabel Sanador
PRESENT=Obsequio
BRICKBREAK=Karatazo
TEETERDANCE=Danza del Caos
FEATHERDANCE=Danza de Plumas
SECRETPOWER=Poder Secreto
AQUARING=Acuaanillo
MAGNETRISE=Superimán
FLAREBLITZ=Erupción
FORCEPALM=Fuerza de Palma
AURASPHERE=Aura Esfera
POISONJAB=Golpe Venenoso
DARKPULSE=Pulso Oscuro
LUCKYCANT=Cántico Suerte
GASTROACID=Ácido Gástrico
LASTRESORT=Último Recurso
SILVERWIND=Viento Plateado
METALSOUND=Sonido Metálico
ASTONISH=Impresión
AIRCUTTER=Aire Cortante
OVERHEAT=Supercalor
ROCKTOMB=Tumba de Rocas
SLACKOFF=Relajar
NEEDLEARM=Brazo Aguja
MUDSPORT=Chapoteo de Lodo
BLASTBURN=Anillo de Fuego
HYPERVOICE=Hipervoz
IRONDEFENSE=Defensa Hierro
AERIALACE=As Aéreo
ICICLESPEAR=Lanza de Hielo
BULLETSEED=Bala Semilla
GRASSWHISTLE=Silbato de Hoja
WATERSPOUT=Columna de Agua
SKYUPPERCUT=Corte Elevado
EXTRASENSORY=Extrasensorial
SHEERCOLD=Frío Extremo
SANDTOMB=Tumba de Arena
PSYCHOBOOST=Psicoimpulso
SHOCKWAVE=Onda de Choque
WATERPULSE=Pulso de Agua
DOOMDESIRE=Deseo Final
WAKEUPSLAP=Despabilador
HAMMERARM=Brazo Martillo
WATERSPORT=Chapoteo de Agua
MAGICALLEAF=Hojas Mágicas
VOLTTACKLE=Tacleada de Voltios
POISONTAIL=Cola Venenosa
MUDSHOT=Disparo de Lodo
BOUNCE=Rebote
DRAGONDANCE=Danza de Dragón
WRINGOUT=Apretón
ASSURANCE=Garantía
CLOSECOMBAT=Cuerpo a Cuerpo
PAYBACK=Revancha
HEALBLOCK=Anticuración
METALBURST=Expl. Metálica
HEALINGWISH=Deseo Sanador
BRINE=Agua Salada
FLAMECHARGE=Carga de Fuego
HEAVYSLAM=Golpe Pesado
ELECTROBALL=Electrobola
STORMTROW=Llave Tempestad
FLAREBURST=Golpe de Fuego
SLUDGEWAVE=Ola de Lodo
QUIVERDANCE=Danza del Aleteo
CLEARSMOG=Humo Claro
AFTERYOU=Ceda el Paso
LOWSWEEP=Barredora
CHATTER=Parloteo
JUDGMENT=Juicio Final
MAGNETBOMB=Magnetobomba
STEALTHROCK=Trampa de Rocas
GRASSKNOT=Nudo de Pasto
ROAROFTIME=Rugido Temporal
AQUAJET=Acuajet
HEADSMASH=Topetazo
WIDEGUARD=Guardia Amplia
OMINOUSWIND=Viento Ominoso
DARKVOID=Abismo Negro
CRUSHGRIP=Garra Aplastante
SPACIALREND=Corte Espacial
LUNARDANCE=Danza de la Luna
POWERSPLIT=Fuerza Dividida
GUARDSPLIT=Guardia Dividida
PSYSHOCK=Choque Psíquico
NIGHTSLASH=Corte Umbrío
AQUATAIL=Cola de Agua
SEEDBOMB=Bomba Semilla
AIRSLASH=Corte Aéreo
DRAINPUNCH=Puño Drenador
SWITCHEROO=Trueque
EARTHPOWER=Poder Terrestre
BRAVEBIRD=Ave Brava
ENERGYBOLA=Bola de Energía
FOCUSBLAST=Ataque Centrado
VACUUMWAVE=Onda de Vacío
THUNDERFANG=Colmillo Trueno
SHADOWCLAW=Garra de Sombra
FIREFANG=Colmillo Fuego
DRACOMETEOR=Meteoro Dragón
LEAFSTORM=Tormenta Hojas
LAVAPLUME=Bomba de Lava
DEFOG=Desempañar
MYSTICALFIRE=Fuego Místico
GRASSYTERRAIN=Campo de Césped
PLAYROUGH=Juego Rudo
PARABOLICCHARGE=Carga Parabólica
PETALBLIZZARD=Tormenta Pétalos
DISARMINGVOICE=Voz Encantadora
DRAININGKISS=Beso Drenador
STICKYWEB=Red Pegajosa
ICICLECRASH=Carámbano
FIERYDANCE=Danza de Llamas
TAILSLAP=Golpe de Cola
HEADCHARGE=Carga de Cabeza
HURRICANE=Huracán
SECRETSWORD=Espada Secreta
RAZORSHELL=Coraza Afilada
HEATCRASH=Golpe de Calor
STEAMROLLER=Aplanadora
DUALCHOP=Golpe Dual
HEARTSTAMP=Sello de Corazón
HORNLEECH=Drenacuerno
SACREDSWORD=Espada Sagrada
COTTOONGUARD=Guardialgodón
NIGHTDAZE=Pulso Nocturno
DRAGONTAIL=Cola de Dragón
FROSTBREATH=Vaho Helado
STRUGGLEBUG=Lucha Insecto
VOLTSWITCH=Cambiavoltaje
WILDCHARGE=Carga Salvaje
ACROBATICS=Acrobacia
INCINERATE=Incinerar
HEALPULSE=Pulso Sanador
QUICKGUARD=Defensa Rápida
STOREDPOWER=Poder Acumulado
ALLYSWITCH=Cambio de Lado
DRAGONASCENT=Ascen. Dracónico
BREAKNECKBLITZ=Carrera Arrolladora
ALLOUTPUMMELING=Ráfaga Demoledora
SUPERSONICSKYSTRIKE=Picada Supersónica
ACIDDOWNPOUR=Diluvio Corrosivo
TECTONICRAGE=Barrena Telúrica
CONTINENTALCRUSH=Aplastamiento Gigalítico
SAVAGESPINOUT=Guadaña Sedosa
NEVERENDINGNIGHTMARE=Presa Espectral
CORKSCREWCRASH=Hélice Trepanadora
INFERNOOVERDRIVE=Hecatombe Pírica
HYDROVORTEX=Hidrovórtice Abisal
BLOOMDOOM=Megatón Floral
GIGAVOLTHAVOC=Gigavoltio Destructor
SHATTEREDPSYCHE=Disruptor Psíquico
SUBZEROSLAMMER=Crioaliento Despiadado
DEVASTATINGDRAKE=Dracoaliento Devastador
BLACKHOLEECLIPSE=Agujero Negro Aniquilador
TWINKLETACKLE=Tacleada Sideral
CATASTROPIKA=Pikavoltio Letal
REVELATIONDANCE=Danza Revelación
POWERTRIP=Arrogancia
SINISTERARROWRAID=Aluvión de Flechas Sombrías
OCEANICOPERETTA=Sinfonía de la Diva Marina
MALICIOUSMOONSAULT=Hiperplancha Oscura
SOULSTEALING7STARSTRIKE=Constelación Robaalmas
GUARDIANOFALOLA=Cólera del Guardián
MAGICPOWDER=Polvo Magia
MAXROCKFALL=Maxirroca
SNAPTRAP=Trampa Presión
10000000VOLTTHUNDERBOLT=Gigarrayo Fulminante
NATURESMADNESS=Ira Natural
SHELLTRAP=Trampa Coraza
GENESISSUPERNOVA=Supernova Original
EXTREMEEVOBOOST=Novena Potencia
PULVERIZINGPANCAKE=Arrojo Intempestivo
STOKEDSPARKSURFER=Surfeo Galvánico
FLOATYFALL=Pikaída
MENACINGMOONRAZEMALSTROM=Deflagración Lunar
SEARINGSUNRAZESMASH=Embestida Solar
SPLINTEREDSTORMSHARDS=Tempestad Rocosa
LETSSNUGGLEFOREVER=Paliza Amistosa
LIGHTTHATBURNSTHESKY=Fotodestrucción Apocalíptica
CLANGOROUSSOULBLAZE=Estruendo Implacable
STEELROLLER=Ferroaplanadora
SCALESHOT=Disparo Escamas
BRANCHPOKE=Ramazo Punzante
BEHEMOTHBASH=Golpe Supremo
BEHEMOTHBLADE=Corte Supremo
CHILLYRECEPTION=Respuesta Fría
AQUACUTTER=Corte Acuático
SURGINGSTRIKES=Golpe Torrencial
JUNGLEHEALING=Selva Sanadora
DUALWINGBEAT=Aletazo Doble
FREEZINGGLARE=Mirada Glacial
WAVECRASH=Acuatacleada
HEADLONGRUSH=Asalto Frontal
CEASELESSEDGE=Corte Metralla
SANDSEARSTORM=Tifón de Arena
ORDERUP=Emplatar
FILLETAWAY=Fileteo
DOODLE=Plagio
SALTCURE=Salación
TORCHSONG=Canto Ígneo
SUPERCELLSLAM=Golpe Voltaico
TEMPERFLARE=Furia Ardiente
MIGHTYCLEAVE=Corte Potente
TACHYONCUTTER=Corte Taquión
FICKLEBEAM=Láser Caprichoso